date,total_admission,total_cases,case_7typlus,case_7tyminus,total_NHS111,NHS111_7typlus,NHS111_7tyminus,google_grocery,google_residential,google_retail,google_transit,google_workplace,apple_driving,apple_transit,apple_walking,percentage_firstdose,percentage_seconddose,total_tested
2020-03-18,3,15,5,10,410,24,386,26.5,9.5,-26.5,-33.5,-21.5,-31.680000000000007,-47.15,-40.06,0,0,306
2020-03-19,14,21,4,17,368,32,336,32,10,-24,-32,-25,-33.83,-56.01,-45.69,0,0,396
2020-03-20,9,23,4,19,369,27,342,15,11.5,-32,-33,-28,-31.590000000000003,-60,-40.82,0,0,454
2020-03-21,16,25,5,20,373,32,341,5,10,-53,-38,-25,-47.96,-69.77,-55.85,0,0,511
2020-03-22,15,29,8,21,435,41,394,-11.5,8,-61.5,-37.5,-28.5,-58.66,-72.2,-66.72,0,0,647
2020-03-23,11,23,6,17,423,29,394,-7.5,15.5,-47.5,-45,-44,-50.61,-70.6,-59.57,0,0,702
2020-03-24,24,38,14,24,346,26,320,-22,21,-73.5,-57,-55.5,-64.93,-80.99,-68.59,0,0,726
2020-03-25,21,39,8,31,358,33,325,-26.5,24,-76.5,-62.5,-62,-67.84,-79.28,-67.2,0,0,735
2020-03-26,20,79,18,61,301,29,272,-26.5,25,-76.5,-63.5,-64,-67.89,-82.77,-66.65,0,0,761
2020-03-27,39,69,23,46,337,22,315,-25.5,26,-79,-66.5,-64.5,-65.08,-81.01,-65.14,0,0,792
2020-03-28,45,39,7,32,323,35,288,-38,19,-86,-71,-56.5,-72.21000000000001,-85.03,-71.74,0,0,762
2020-03-29,21,56,14,42,329,34,295,-45,15.5,-87.5,-72,-54,-77.33,-83.48,-76.11,0,0,772
2020-03-30,28,69,12,57,302,23,279,-34,25,-77.5,-69,-67.5,-70.39,-83.08,-72.53999999999999,0,0,823
2020-03-31,59,85,19,66,289,34,255,-31,25,-75.5,-66,-67.5,-69.32,-80.32,-69.53,0,0,863
2020-04-01,39,81,14,67,296,26,270,-34,26,-77.5,-69,-68,-69.73,-81.03999999999999,-69.23,0,0,905
2020-04-02,50,99,22,77,205,19,186,-32.5,26,-76.5,-69,-68,-68.56,-81.32,-67.99000000000001,0,0,917
2020-04-03,62,86,24,62,208,21,187,-31.5,27,-78,-67.5,-67,-64.85,-84.2,-66.11,0,0,943
2020-04-04,62,62,11,51,219,30,189,-38,18,-83,-66.5,-56,-69.55,-85.78999999999999,-66.49000000000001,0,0,958
2020-04-05,57,49,8,41,241,34,207,-41.5,14.5,-84,-65.5,-51.5,-75.57,-85.38,-72.76,0,0,961
2020-04-06,73,76,22,54,239,25,214,-33,25,-74.5,-67,-67.5,-68.08,-82.27,-69.01,0,0,964
2020-04-07,48,96,23,73,231,17,214,-30,25,-75,-63.5,-67.5,-67.59,-81.94,-64.22,0,0,995
2020-04-08,55,77,19,58,202,16,186,-29,25.5,-75.5,-64,-68,-66.45,-83.06,-64.47,0,0,999
2020-04-09,78,99,22,77,156,17,139,-22,25,-72.5,-64.5,-68.5,-64.63,-82.75,-64.52000000000001,0,0,1014
2020-04-10,81,52,10,42,187,17,170,-32,29.5,-79,-70.5,-79,-68.08,-82.18,-63.88,0,0,991
2020-04-11,61,58,16,42,228,34,194,-34.5,18,-83,-65.5,-56.5,-71.36,-83.46000000000001,-66.97,0,0,981
2020-04-12,64,93,11,82,208,22,186,-67,15.5,-92,-68.5,-57.5,-77.11,-84.48,-73.96000000000001,0,0,1077
2020-04-13,55,86,17,69,187,13,174,-44.5,30,-80.5,-76,-82.5,-73.63,-84.27,-73.41,0,0,1080
2020-04-14,56,117,42,75,197,20,177,-27,25,-72.5,-63,-68,-64.46000000000001,-81.06,-63.37,0,0,1074
2020-04-15,35,99,19,80,189,14,175,-29.5,25.5,-74.5,-63.5,-67,-64.06,-81.03999999999999,-59.55,0,0,1114
2020-04-16,73,137,28,109,155,16,139,-27,25.5,-75,-62.5,-67,-62.67,-80.89,-60.55,0,0,1177
2020-04-17,44,156,35,121,139,14,125,-29,27,-77.5,-65.5,-66.5,-60.01,-82.77,-61.04,0,0,1293
2020-04-18,31,72,9,63,207,29,178,-40,18.5,-84.5,-69.5,-54,-67.3,-84.36,-68.82,0,0,1355
2020-04-19,40,101,8,93,160,31,129,-41,13.5,-83.5,-61,-46.5,-71.16,-84.08,-68.19,0,0,1351
2020-04-20,41,79,26,53,154,9,145,-32.5,24,-73.5,-62.5,-65,-64.1,-80.49,-62.57,0,0,1394
2020-04-21,44,102,20,82,163,19,144,-30,24,-74.5,-62.5,-64.5,-61.83,-81.51,-64.05,0,0,1421
2020-04-22,40,186,26,160,124,9,115,-30.5,24.5,-75.5,-62,-64.5,-61.82,-81.06,-62.17,0,0,1772
2020-04-23,43,168,26,142,131,18,113,-28.5,24.5,-74,-62.5,-64.5,-62.32,-82.65,-60.38,0,0,1939
2020-04-24,38,133,29,104,157,13,144,-27.5,25,-75.5,-62,-63.5,-57.9,-83.17,-58.3,0,0,2039
2020-04-25,34,66,5,61,122,23,99,-33.5,16.5,-80.5,-60,-50,-64.6,-84.39,-60.96,0,0,2096
2020-04-26,33,56,2,54,128,19,109,-39.5,13.5,-82.5,-61,-46.5,-70.6,-83.96000000000001,-69.27,0,0,2040
2020-04-27,30,124,29,95,152,9,143,-31.5,23,-72,-61.5,-64,-62.24,-81.3,-65.35,0,0,2469
2020-04-28,43,94,20,74,141,15,126,-33.5,23,-75.5,-66,-65,-61.74,-81.82,-70.52,0,0,2781
2020-04-29,31,131,27,104,121,19,102,-31.5,25,-76.5,-66,-64,-60.58,-84.34,-67.22,0,0,3298
2020-04-30,30,119,17,102,117,15,102,-28.5,25,-75.5,-64.5,-63.5,-59.76,-81.89,-65.77000000000001,0,0,4067
2020-05-01,20,126,24,102,120,12,108,-28,25,-76.5,-63.5,-63,-55.31,-79.82,-61.25,0,0,4797
2020-05-02,23,61,7,54,116,16,100,-32.5,16.5,-80.5,-58,-47.5,-60.08,-84.32,-60.66,0,0,5163
2020-05-03,28,66,12,54,123,19,104,-38,13.5,-82.5,-59.5,-45,-68.2,-83.17,-70.72,0,0,5532
2020-05-04,16,79,15,64,157,16,141,-30,23,-71.5,-59.5,-62,-59.95,-82.7,-63.67,0,0,5483
2020-05-05,15,66,13,53,116,17,99,-28,23,-72,-58,-62,-57.2,-79.13,-62.59,0,0,5711
2020-05-06,12,70,16,54,111,8,103,-24,23,-72.5,-57,-61,-56.2,-80.16,-59.7,0,0,5427
2020-05-07,18,59,11,48,75,11,64,-15.5,22,-68,-56.5,-61.5,-55.07,-78.99,-56.97,0,0,5154
2020-05-08,19,62,13,49,128,31,97,-30.5,27.5,-77.5,-65,-76,-60.02,-83.53,-59.25,0,0,4836
2020-05-09,17,44,4,40,126,24,102,-31,16,-80,-58,-48,-60.75,-82.89,-58.96,0,0,4872
2020-05-10,18,35,5,30,108,11,97,-40.5,14,-83.5,-68,-45.5,-67.65,-83.53,-72.48,0,0,5082
2020-05-11,12,91,22,69,122,9,113,-28.5,22.5,-69.5,-59,-60.5,-67.65,-83.53,-72.48,0,0,5611
2020-05-12,15,92,16,76,110,13,97,-25.5,23,-70.5,-57.5,-60.5,-67.65,-83.53,-72.48,0,0,6055
2020-05-13,17,69,8,61,115,8,107,-25.5,22.5,-71.5,-58,-59,-50.73,-79.8,-55.22,0,0,6437
2020-05-14,15,55,7,48,96,9,87,-22,20.5,-70,-53.5,-58.5,-46.97,-78.94,-54.59,0,0,6536
2020-05-15,14,58,7,51,82,11,71,-22,22,-72,-55,-58.5,-41.28,-78.4,-51.04,0,0,6801
2020-05-16,14,33,1,32,96,12,84,-26.5,14,-77.5,-52,-42.5,-46.85,-81.42,-52.7,0,0,7064
2020-05-17,16,57,9,48,111,15,96,-29.5,11.5,-78,-47.5,-37,-53.43,-81.08,-61.23,0,0,6992
2020-05-18,13,61,7,54,108,14,94,-23,20.5,-66,-51,-57,-44.3,-77.42,-55.67,0,0,6973
2020-05-19,26,86,17,69,79,10,69,-19.5,20.5,-67,-50,-57,-42.32,-74.05,-47.86,0,0,6944
2020-05-20,22,69,8,61,69,7,62,-17,20.5,-69,-52.5,-57,-40.88,-77.57,-49.72,0,0,6930
2020-05-21,16,59,10,49,44,5,39,-16.5,21,-67,-51.5,-57.5,-39.55,-76.16,-51,0,0,7071
2020-05-22,9,115,31,84,37,7,30,-18,22,-69.5,-54.5,-57,-33.989999999999995,-77.14,-45.09,0,0,7228
2020-05-23,22,23,1,22,39,12,27,-23.5,14,-75.5,-53.5,-40.5,-40.93,-77.78,-52.98,0,0,7140
2020-05-24,6,40,0,40,53,13,40,-26.5,10.5,-76,-48.5,-35.5,-50.12,-79.35,-61.35,0,0,7278
2020-05-25,8,44,2,42,48,6,42,-26.5,23.5,-70.5,-55.5,-76.5,-42.01,-77.99,-52.9,0,0,6965
2020-05-26,6,55,14,41,43,7,36,-14,19,-64,-49,-56.5,-35.7,-74.41,-49.32,0,0,6712
2020-05-27,11,52,13,39,25,2,23,-15.5,19.5,-65.5,-49,-56,-34.620000000000005,-70.27,-46.95,0,0,6897
2020-05-28,12,60,13,47,36,6,30,-13.5,19,-64,-48.5,-56,-30.14,-72.96000000000001,-45.42,0,0,7009
2020-05-29,9,45,11,34,27,3,24,-13,20,-67,-49,-55,-24.769999999999996,-69.39,-38.51,0,0,7012
2020-05-30,16,53,8,45,28,4,24,-18,11,-74,-44,-31.5,-30.299999999999997,-73.1,-41.15,0,0,7211
2020-05-31,14,31,5,26,23,8,15,-20.5,8.5,-74,-40.5,-26,-38.48,-72.67,-53.59,0,0,7280
2020-06-01,12,104,23,81,40,7,33,-15.5,17.5,-60,-45,-52,-30.599999999999994,-67.35,-44.83,0,0,8055
2020-06-02,15,84,11,73,22,2,20,-15,17,-63,-45.5,-52,-22.569999999999993,-68.49,-41.97,0,0,8773
2020-06-03,9,34,3,31,31,2,29,-23,20.5,-68,-56.5,-53.5,-34.980000000000004,-73.31,-54.07,0,0,9137
2020-06-04,22,56,14,42,33,4,29,-17,19,-64,-48,-52,-30.58,-71.96000000000001,-50.95,0,0,9421
2020-06-05,12,58,8,50,23,6,17,-19,20,-67.5,-52,-52,-27.36,-72.53,-49.43,0,0,9839
2020-06-06,9,37,2,35,42,11,31,-23.5,13,-73,-50.5,-33.5,-33.78,-75.88,-52.27,0,0,9625
2020-06-07,6,22,3,19,38,8,30,-26,10.5,-73.5,-48.5,-31,-41.89,-72.2,-55.94,0,0,9613
2020-06-08,2,36,3,33,31,2,29,-19.5,17.5,-60,-46,-50,-33.510000000000005,-69.25,-46.85,0,0,9512
2020-06-09,8,42,5,37,38,4,34,-19,17.5,-61.5,-45.5,-50.5,-29.700000000000003,-66.47,-46.35,0,0,9566
2020-06-10,9,46,4,42,29,2,27,-20.5,19.5,-64.5,-51.5,-51.5,-30.180000000000007,-68.08,-50.07,0,0,9536
2020-06-11,12,38,5,33,47,4,43,-20.5,20,-63,-53,-51.5,-30.450000000000003,-67.78,-52,0,0,9365
2020-06-12,11,35,2,33,42,2,40,-16.5,20,-65,-51,-50.5,-24.840000000000003,-69.18,-42.35,0,0,9106
2020-06-13,6,13,1,12,35,12,23,-18,10,-69.5,-39.5,-24,-25.14,-70.53,-40.09,0,0,9059
2020-06-14,6,16,1,15,32,8,24,-21.5,8.5,-70,-39,-20.5,-35.7,-72.1,-55.18,0,0,8842
2020-06-15,7,49,5,44,57,7,50,-17,16.5,-51,-43,-49,-27.72,-68.01,-44.28,0,0,8458
2020-06-16,5,42,5,37,49,8,41,-14.5,17,-54.5,-42.5,-49,-26.03,-65.92,-43.6,0,0,7951
2020-06-17,5,46,3,43,45,7,38,-17.5,17.5,-57,-47,-49,-24.840000000000003,-69.68,-45.29,0,0,7321
2020-06-18,5,41,5,36,23,0,23,-19,19,-60.5,-51,-51.5,-27.36,-63.88,-50.41,0,0,7060
2020-06-19,6,38,5,33,27,9,18,-11.5,18,-58,-45.5,-49,-16.459999999999994,-63.09,-35.16,0,0,6917
2020-06-20,6,19,1,18,32,9,23,-11,8,-63,-33,-21.5,-19.099999999999994,-69.44,-36.24,0,0,6902
2020-06-21,6,23,0,23,37,7,30,-16.5,6.5,-65.5,-35.5,-15.5,-33.8,-68.75,-54.69,0,0,6905
2020-06-22,4,36,3,33,31,3,28,-14,15,-50,-37.5,-50,-13.829999999999998,-57.53,-32.8,0,0,6892
2020-06-23,13,25,4,21,38,9,29,-9.5,15,-52.5,-37.5,-48.5,-16.060000000000002,-58.22,-31.480000000000004,0,0,7247
2020-06-24,9,19,0,19,35,9,26,-8,15.5,-56.5,-41,-48,-13.239999999999995,-55.28,-28.560000000000002,0,0,7415
2020-06-25,4,26,0,26,24,6,18,-6.5,15,-55.5,-40,-48,-12.079999999999998,-56.32,-30.810000000000002,0,0,7473
2020-06-26,3,15,0,15,22,6,16,-9,16,-57.5,-41,-47.5,-10.370000000000005,-58.77,-32.519999999999996,0,0,7575
2020-06-27,3,9,2,7,45,14,31,-14.5,10,-62.5,-39,-25,-16.790000000000006,-65.71000000000001,-42.08,0,0,7551
2020-06-28,7,10,0,10,30,9,21,-17.5,7.5,-63.5,-38,-17.5,-26.299999999999997,-63.62,-54.59,0,0,7603
2020-06-29,4,20,2,18,41,6,35,-16.5,16,-49.5,-42,-48,-20.090000000000003,-56.51,-46.73,0,0,7936
2020-06-30,7,11,0,11,29,5,24,-12,15,-49,-40.5,-46,-13.379999999999995,-52.47,-34.14,0,0,7761
2020-07-01,8,14,3,11,30,8,22,-13.5,15.5,-52,-43.5,-46.5,-16.409999999999997,-54.06,-38.25,0,0,7896
2020-07-02,0,15,1,14,26,6,20,-12,16,-51,-44,-47.5,-16.150000000000006,-59.05,-35.68000000000001,0,0,8037
2020-07-03,0,7,0,7,33,6,27,-12.5,16,-55,-44,-46,-7.810000000000002,-56.49,-35.61,0,0,7747
2020-07-04,0,17,4,13,33,9,24,-15.5,7,-56,-31.5,-18,-12.760000000000005,-61.81,-21.439999999999998,0,0,7829
2020-07-05,2,6,0,6,26,5,21,-17,5.5,-56.5,-30,-14.5,-25.310000000000002,-59.7,-47.45,0,0,7762
2020-07-06,0,10,1,9,22,6,16,-14.5,13,-43,-33,-47,-11.579999999999998,-51.14,-30.560000000000002,0,0,7519
2020-07-07,0,10,1,9,29,7,22,-18,14.5,-48.5,-40.5,-47.5,-10.209999999999994,-52.04,-37.28,0,0,7656
2020-07-08,1,6,0,6,30,5,25,-16,15,-49,-42,-46,-12.019999999999996,-52.88,-32.81999999999999,0,0,7863
2020-07-09,1,12,1,11,26,7,19,-14.5,15,-48.5,-39.5,-46.5,-12.709999999999994,-54.25,-31.14,0,0,8001
2020-07-10,0,9,1,8,36,7,29,-13,13,-48.5,-35,-45,-2.0900000000000034,-52.35,-19.730000000000004,0,0,8121
2020-07-11,0,9,1,8,43,13,30,-14,5,-52.5,-24.5,-16,-8.64,-56.65,-11.409999999999997,0,0,8072
2020-07-12,1,6,0,6,29,10,19,-14,3,-53.5,-20,-11,-18.209999999999994,-58.39,-38.88,0,0,8183
2020-07-13,3,10,0,10,40,11,29,-15.5,12.5,-42,-35,-46,-11.129999999999995,-48.43,-28.17,0,0,8414
2020-07-14,1,21,1,20,35,7,28,-14,13,-41,-35,-45.5,-9.579999999999998,-46.89,-24.42,0,0,8662
2020-07-15,0,10,1,9,26,3,23,-17,14,-40,-44.5,-44.5,-7.950000000000003,-46.98,-22.790000000000006,0,0,9004
2020-07-16,1,9,2,7,35,9,26,-13.5,12.5,-36,-38,-43.5,-6.599999999999994,-47.48,-22.75,0,0,9168
2020-07-17,0,15,2,13,28,6,22,-12.5,11,-38.5,-37.5,-43,2.6200000000000045,-46.67,-4.859999999999999,0,0,9335
2020-07-18,2,6,1,5,27,4,23,-17.5,5,-45,-33.5,-16,-4.810000000000002,-54.09,-3.6599999999999966,0,0,9562
2020-07-19,0,13,0,13,17,8,9,-15.5,2.5,-43,-28.5,-9.5,-15.36,-50.12,-37.23,0,0,9652
2020-07-20,1,11,1,10,34,5,29,-15,11.5,-33,-37.5,-44.5,-5.569999999999993,-42.49,-25.959999999999994,0,0,9615
2020-07-21,0,9,2,7,37,6,31,-15.5,12,-34.5,-38,-44.5,-6.290000000000006,-42.11,-21.340000000000003,0,0,9295
2020-07-22,0,11,0,11,36,4,32,-14,12,-36.5,-40,-42.5,-4.799999999999997,-46.58,-21.799999999999997,0,0,8796
2020-07-23,1,13,1,12,18,4,14,-12,12.5,-34.5,-39.5,-43,-2.0799999999999983,-47.55,-23.08,0,0,8632
2020-07-24,1,22,1,21,26,5,21,-15,10.5,-37,-35,-42,6.109999999999999,-45.79,-6.6299999999999955,0,0,8629
2020-07-25,0,25,1,24,41,17,24,-20.5,5.5,-44.5,-34.5,-17,-2.530000000000001,-52.76,-1.8499999999999943,0,0,8661
2020-07-26,1,4,0,4,37,11,26,-18,2.5,-42.5,-28,-10.5,-13.849999999999994,-54.44,-37.08,0,0,8613
2020-07-27,0,24,1,23,26,5,21,-20,13,-35,-40.5,-49,-3.480000000000004,-44.27,-29.33,0,0,8597
2020-07-28,0,28,0,28,23,6,17,-14,11.5,-31.5,-36,-46,0.01999999999999602,-43.42,-19.549999999999997,0,0,8641
2020-07-29,1,17,0,17,26,8,18,-14.5,11.5,-33,-38,-46,0.269999999999996,-40.95,-16.180000000000007,0,0,9080
2020-07-30,1,20,2,18,22,4,18,-11,11,-29.5,-32,-46.5,3.6700000000000017,-40.54,-15.870000000000005,0,0,9378
2020-07-31,0,26,5,21,28,6,22,-15.5,9.5,-37.5,-34.5,-47.5,5.409999999999997,-47.79,-4.25,0,0,9442
2020-08-01,0,7,0,7,25,8,17,-18,3,-41,-24.5,-15.5,-2.1099999999999994,-52.19,13.349999999999994,0,0,9527
2020-08-02,1,25,0,25,14,4,10,-18,1.5,-39,-22.5,-10.5,-10.379999999999995,-50.4,-30.819999999999993,0,0,9557
2020-08-03,0,28,1,27,38,8,30,-18,10,-23.5,-33,-47.5,1.2199999999999989,-40.97,-12.299999999999997,0,0,10016
2020-08-04,1,24,3,21,25,9,16,-19,11,-24.5,-35.5,-47.5,1.6299999999999955,-41.8,-8.450000000000003,0,0,10489
2020-08-05,2,22,2,20,38,2,36,-19.5,11,-24,-39.5,-46,3.6099999999999994,-43.39,-6.859999999999999,0,0,10836
2020-08-06,0,19,2,17,33,3,30,-15.5,11,-30.5,-36,-47,3.519999999999996,-46.25,-11.090000000000003,0,0,11216
2020-08-07,0,27,0,27,23,6,17,-16.5,9,-35.5,-36.5,-46.5,12.099999999999994,-46.98,0.7600000000000051,0,0,11670
2020-08-08,0,13,1,12,30,16,14,-18.5,2,-41.5,-29.5,-15,-0.9099999999999966,-52.45,16.03,0,0,11633
2020-08-09,0,14,0,14,29,10,19,-19.5,1.5,-38.5,-29.5,-11.5,-10.370000000000005,-50.55,-30.39,0,0,11678
2020-08-10,1,51,10,41,29,5,24,-18,9.5,-16.5,-35,-47.5,3.819999999999993,-35.86,-6.6299999999999955,0,0,11966
2020-08-11,0,28,1,27,32,8,24,-17,10,-19,-37,-46.5,2.260000000000005,-35.459999999999994,-2.480000000000004,0,0,12318
2020-08-12,1,41,0,41,29,6,23,-16,10,-20,-37.5,-46,2.5600000000000023,-42.97,-6.900000000000006,0,0,13322
2020-08-13,0,28,2,26,31,8,23,-15,11,-30,-37.5,-46.5,2.6500000000000057,-29.799999999999997,-8.959999999999994,0,0,14078
2020-08-14,0,28,1,27,28,3,25,-15,9.5,-31.5,-34,-45,11.299999999999997,-36,6.959999999999994,0,0,14533
2020-08-15,1,20,0,20,34,10,24,-19.5,3,-38.5,-27,-16.5,2.489999999999995,-42.4,18.129999999999995,0,0,14561
2020-08-16,0,19,0,19,30,9,21,-23,3.5,-42,-36,-15,-12.730000000000004,-45.15,-34.64,0,0,14832
2020-08-17,1,45,3,42,33,4,29,-19.5,10,-15.5,-34.5,-46.5,3.3700000000000045,-29.540000000000006,-5.640000000000001,0,0,15171
2020-08-18,3,23,0,23,34,3,31,-18,10,-16,-37.5,-44,6.530000000000001,-32.3,1.3299999999999983,0,0,15348
2020-08-19,1,31,3,28,37,5,32,-22,11,-22.5,-42.5,-45,9.129999999999995,-23.310000000000002,-0.3499999999999943,0,0,15654
2020-08-20,3,32,0,32,28,4,24,-14,9,-26,-35,-43.5,6.25,-29.25,-2.3499999999999943,0,0,15457
2020-08-21,0,47,1,46,42,5,37,-16.5,10,-32.5,-37.5,-44.5,12.329999999999998,-29.28,7.239999999999995,0,0,15666
2020-08-22,1,17,1,16,35,11,24,-19,3,-37,-32,-13.5,5.900000000000006,-38.07,23.760000000000005,0,0,15944
2020-08-23,1,13,0,13,48,11,37,-19,2.5,-37,-29.5,-12.5,-10.459999999999994,-41.99,-28.900000000000006,0,0,15884
2020-08-24,2,18,0,18,37,6,31,-17.5,8.5,-9.5,-34,-45,5.549999999999997,-26.049999999999997,0.4399999999999977,0,0,15567
2020-08-25,0,10,2,8,30,5,25,-21,11.5,-18.5,-43.5,-46.5,4.590000000000003,-21.769999999999996,-0.7800000000000011,0,0,15425
2020-08-26,0,41,2,39,30,7,23,-16,8.5,-11.5,-37.5,-42,8.680000000000007,-26.120000000000005,13.239999999999995,0,0,15105
2020-08-27,0,24,2,22,36,4,32,-16,10.5,-27.5,-37.5,-44.5,8.180000000000007,-26.83,-1.0600000000000023,0,0,15019
2020-08-28,1,26,0,26,30,3,27,-16,10,-30.5,-38,-45,19.260000000000005,-28.900000000000006,14.290000000000006,0,0,14543
2020-08-29,0,17,0,17,21,4,17,-16,3,-32,-28.5,-14.5,8.439999999999998,-33.91,39.129999999999995,0,0,14541
2020-08-30,0,37,0,37,42,10,32,-16.5,0.5,-26.5,-24.5,-12.5,-6.040000000000006,-39.33,11.790000000000006,0,0,14406
2020-08-31,0,30,0,30,56,15,41,-23,13,-5,-40.5,-69,1.9200000000000017,-33.39,-2.489999999999995,0,0,13491
2020-09-01,0,69,4,65,50,9,41,-7,8,-20.5,-32.5,-42.5,10.5,-22.36,12.61,0,0,13527
2020-09-02,0,94,3,91,49,4,45,-15,10,-27.5,-38.5,-40,8.579999999999998,-16.659999999999997,4.810000000000002,0,0,13942
2020-09-03,0,97,1,96,56,10,46,-11.5,9,-24,-34,-40,9.810000000000002,-15.349999999999994,7.849999999999994,0,0,14750
2020-09-04,0,56,2,54,43,7,36,-11.5,7.5,-27.5,-31,-38.5,18.129999999999995,-21.129999999999995,24,0,0,15578
2020-09-05,0,63,3,60,47,9,38,-15,2.5,-31.5,-29.5,-11,14.790000000000006,-24.260000000000005,54.06999999999999,0,0,15943
2020-09-06,0,78,1,77,78,9,69,-13,2,-32,-28,-10,-1.7000000000000028,-24.519999999999996,-8.200000000000003,0,0,16420
2020-09-07,2,128,7,121,131,5,126,-15,8,-24,-33,-41.5,7.1299999999999955,-7.599999999999994,12.689999999999998,0,0,18132
2020-09-08,0,81,7,74,107,4,103,-14,7.5,-24.5,-32.5,-40,10.590000000000003,-9.739999999999995,19.739999999999995,0,0,18876
2020-09-09,1,107,3,104,105,6,99,-14.5,8,-27.5,-34,-37.5,5.719999999999999,-18.08,14.530000000000001,0,0,19384
2020-09-10,0,44,3,41,126,6,120,-12.5,7.5,-26.5,-32.5,-39,5.719999999999999,-17.180000000000007,7.1200000000000045,0,0,19907
2020-09-11,6,83,4,79,104,4,100,-11,6.5,-28,-29.5,-37.5,20.599999999999994,-19.870000000000005,28.159999999999997,0,0,21125
2020-09-12,3,31,1,30,127,15,112,-14,2,-32,-28,-10.5,17.409999999999997,-25.019999999999996,74.16999999999999,0,0,21305
2020-09-13,5,48,4,44,149,9,140,-11.5,0.5,-32,-23.5,-7.5,3.739999999999995,-17.090000000000003,8.719999999999999,0,0,21118
2020-09-14,0,76,2,74,213,5,208,-13,7,-23.5,-30,-36,10.5,-7.3700000000000045,27.769999999999996,0,0,20952
2020-09-15,5,62,2,60,174,8,166,-11.5,7.5,-25.5,-31,-35.5,10.200000000000003,-7.25,29.47999999999999,0,0,20835
2020-09-16,2,67,4,63,141,8,133,-16,8,-31.5,-34,-35.5,13.739999999999995,-7.010000000000005,35.47999999999999,0,0,21167
2020-09-17,4,75,3,72,112,4,108,-11.5,7.5,-25,-30.5,-36,21.459999999999994,6.920000000000002,48.31,0,0,21418
2020-09-18,0,75,3,72,129,4,125,-10,7,-27.5,-29.5,-35,30.629999999999995,10.079999999999998,90.25999999999999,0,0,21257
2020-09-19,3,80,3,77,94,9,85,-12,2.5,-30.5,-29,-11.5,37.19,8.129999999999995,152.33,0,0,21159
2020-09-20,1,107,6,101,113,4,109,-11.5,1.5,-29.5,-25,-8.5,21.480000000000004,33.46000000000001,100.4,0,0,21548
2020-09-21,0,100,1,99,138,13,125,-10.5,7,-22.5,-30,-36,20.430000000000007,46.389999999999986,116.05000000000001,0,0,21164
2020-09-22,2,88,5,83,115,8,107,-10,8,-25.5,-32,-34.5,18.409999999999997,41.83000000000001,111.41999999999999,0,0,20622
2020-09-23,3,124,0,124,137,11,126,-14.5,9.5,-34,-39,-34,14.510000000000005,41.349999999999994,95.94999999999999,0,0,20646
2020-09-24,3,162,2,160,97,6,91,-10.5,9,-28.5,-36,-34,19.129999999999995,29.849999999999994,85.1,0,0,20892
2020-09-25,2,211,3,208,89,7,82,-5.5,8,-28.5,-33.5,-33.5,38.84,41.91999999999999,135.18,0,0,20861
2020-09-26,7,216,6,210,69,9,60,-10,4,-31.5,-34,-9,33.97,33.25,182.12,0,0,21056
2020-09-27,4,343,5,338,82,7,75,-10.5,3.5,-33.5,-29.5,-7.5,11.39,34.96000000000001,93.24000000000001,0,0,21158
2020-09-28,4,554,11,543,116,4,112,-10,8,-23,-33,-33,17,52.80000000000001,104.62,0,0,21451
2020-09-29,6,534,4,530,120,5,115,-8.5,8,-25,-33.5,-32,16.650000000000006,50.59,115.85,0,0,22075
2020-09-30,7,850,4,846,169,9,160,-12,9,-30.5,-37,-32.5,16.25,47.599999999999994,97.72999999999999,0,0,22563
2020-10-01,5,1209,10,1199,122,6,116,-7,8,-26.5,-33,-31.5,10.510000000000005,27.569999999999993,86.18,0,0,24180
2020-10-02,8,1353,7,1346,115,7,108,-8,8.5,-31.5,-29.5,-31.5,21.019999999999996,33.97999999999999,101.06,0,0,25826
2020-10-03,14,1225,9,1216,133,18,115,-14.5,6,-37,-37.5,-13,15.129999999999995,9.219999999999999,101.87,0,0,27188
2020-10-04,6,1463,11,1452,123,18,105,-11.5,3.5,-33.5,-27,-7.5,-2.4599999999999937,6.349999999999994,41.99000000000001,0,0,28181
2020-10-05,6,1909,9,1900,189,12,177,-13.5,8.5,-28.5,-31.5,-33.5,1.5699999999999932,20.480000000000004,37.610000000000014,0,0,30001
2020-10-06,6,1708,14,1694,154,7,147,-11,9,-30,-32,-33,0.25,14.159999999999997,36.25,0,0,31384
2020-10-07,19,1838,25,1813,151,10,141,-11,8.5,-31.5,-34.5,-30.5,1.519999999999996,9.319999999999993,42.31999999999999,0,0,33026
2020-10-08,15,2171,21,2150,172,11,161,-12,9.5,-32,-34,-32.5,-1.019999999999996,5.3700000000000045,29.25999999999999,0,0,34793
2020-10-09,10,1372,17,1355,129,11,118,-9.5,8.5,-33.5,-33.5,-31.5,5.519999999999996,4.1299999999999955,36.16,0,0,35524
2020-10-10,20,1140,19,1121,118,11,107,-14,5.5,-38,-38,-9.5,1.6899999999999977,-15.069999999999993,53.75999999999999,0,0,35508
2020-10-11,19,941,18,923,120,12,108,-14,4,-38,-32,-8,-11.810000000000002,-15.680000000000007,4.819999999999993,0,0,35092
2020-10-12,26,1594,22,1572,172,6,166,-16,9.5,-33.5,-36,-34,-9.930000000000007,-4.900000000000006,5.799999999999997,0,0,34843
2020-10-13,24,1403,41,1362,184,7,177,-12.5,10,-33.5,-36.5,-33.5,-6.780000000000001,-0.7399999999999949,17.739999999999995,0,0,34964
2020-10-14,36,1525,38,1487,141,7,134,-14,11,-39,-39,-32.5,-5.019999999999996,-0.06999999999999318,20.480000000000004,0,0,35651
2020-10-15,43,1171,21,1150,124,10,114,-11,10.5,-35,-36,-33,-5.829999999999998,-0.29000000000000625,23.36,0,0,34987
2020-10-16,39,882,19,863,95,12,83,-9,11,-37.5,-37,-33,1.0699999999999932,2.989999999999995,39.06999999999999,0,0,34679
2020-10-17,19,906,26,880,135,14,121,-14,7,-42,-43,-12.5,-4.700000000000003,4.3700000000000045,54.09,0,0,34530
2020-10-18,32,681,20,661,93,14,79,-15.5,5.5,-42,-38.5,-11,-13.219999999999999,-2.6400000000000006,9.420000000000002,0,0,34487
2020-10-19,19,1550,49,1501,172,16,156,-17,11.5,-32.5,-39,-42.5,-4.950000000000003,7.030000000000001,24.180000000000007,0,0,34784
2020-10-20,53,1283,75,1208,119,9,110,-15.5,12,-34.5,-41,-41.5,-3.569999999999993,4.730000000000004,39.620000000000005,0,0,35095
2020-10-21,35,1186,32,1154,108,17,91,-19,14,-40,-44.5,-42,-5.469999999999999,8.170000000000002,31.159999999999997,0,0,35618
2020-10-22,60,1196,46,1150,112,10,102,-12.5,12,-32.5,-39,-41,-3.430000000000007,7.980000000000004,30.150000000000006,0,0,36171
2020-10-23,46,992,42,950,115,5,110,-11,12.5,-36.5,-40.5,-41,4.599999999999994,11.549999999999997,43.56,0,0,37286
2020-10-24,60,681,24,657,81,16,65,-16.5,8,-43.5,-46,-14,-8.540000000000006,-11.290000000000006,26,0,0,37331
2020-10-25,25,752,26,726,109,14,95,-9.5,4.5,-35.5,-36.5,-9,-14.150000000000006,-10.150000000000006,3.0400000000000063,0,0,37262
2020-10-26,55,1280,55,1225,133,14,119,-13.5,12,-27.5,-41.5,-44,-3.9099999999999966,1.4300000000000068,18.799999999999997,0,0,35830
2020-10-27,36,1141,68,1073,91,7,84,-14,13,-31,-44,-43.5,-3.3400000000000034,-4.230000000000004,22.64,0,0,34144
2020-10-28,84,1126,45,1081,115,17,98,-12,12,-29,-41.5,-41,-0.7999999999999972,-0.5499999999999972,37.34,0,0,32641
2020-10-29,40,1110,58,1052,101,12,89,-12,13.5,-30.5,-45.5,-42.5,-6.700000000000003,-10.909999999999997,9.489999999999995,0,0,32061
2020-10-30,52,1150,94,1056,122,12,110,-8,14,-42,-45,-43.5,-2.75,-15.159999999999997,22.049999999999997,0,0,31349
2020-10-31,45,716,32,684,94,17,77,-12,10,-50,-49.5,-17.5,-18.11,-26.569999999999993,7.1200000000000045,0,0,31260
2020-11-01,34,603,19,584,122,16,106,-14.5,7,-43,-42.5,-15,-28.459999999999994,-30.439999999999998,-20.97,0,0,31249
2020-11-02,40,1574,88,1486,115,15,100,-11.5,11.5,-27,-40,-34,-13.450000000000003,-11.36,10.590000000000003,0,0,30902
2020-11-03,55,1179,59,1120,112,12,100,-8.5,10.5,-25.5,-38,-33,-9.11,-9.739999999999995,16.349999999999994,0,0,30987
2020-11-04,47,985,61,924,111,10,101,-6.5,10,-24,-38,-31.5,-6.1299999999999955,-8.370000000000005,35.59,0,0,30683
2020-11-05,52,887,29,858,108,8,100,-15,15,-59,-47,-38,-28.700000000000003,-39.02,-18.299999999999997,0,0,30663
2020-11-06,57,923,39,884,108,5,103,-12,16,-61,-50.5,-38.5,-20.560000000000002,-31.819999999999993,-5.650000000000006,0,0,30967
2020-11-07,45,691,22,669,92,15,77,-18,13,-67,-59.5,-30.5,-30.959999999999994,-41.75,-12.480000000000004,0,0,30873
2020-11-08,37,575,18,557,74,13,61,-19,10.5,-67.5,-58.5,-29.5,-42.89,-37.48,-29.689999999999998,0,0,30424
2020-11-09,43,916,48,868,137,10,127,-17,14.5,-54,-48,-39.5,-26.909999999999997,-29.230000000000004,-9.299999999999997,0,0,30105
2020-11-10,59,874,64,810,111,6,105,-13.5,14,-55,-46,-39.5,-24.700000000000003,-30.040000000000006,-3.980000000000004,0,0,30020
2020-11-11,60,1050,50,1000,110,12,98,-15.5,15,-58,-47.5,-38,-24.53,-27.159999999999997,-2.980000000000004,0,0,30297
2020-11-12,63,687,30,657,75,6,69,-11.5,15,-55.5,-45.5,-38.5,-25.120000000000005,-30.040000000000006,-8.25,0,0,30500
2020-11-13,51,857,38,819,65,9,56,-7.5,16,-57.5,-47.5,-38.5,-17.299999999999997,-28.540000000000006,2.769999999999996,0,0,30937
2020-11-14,45,604,25,579,90,19,71,-15,13,-65.5,-60.5,-29.5,-31.53,-44.11,-15.719999999999999,0,0,31189
2020-11-15,33,482,23,459,93,15,78,-17.5,10,-64.5,-56,-28.5,-41.51,-45.41,-37.07,0,0,31165
2020-11-16,47,939,44,895,101,4,97,-15.5,14,-52.5,-46.5,-39,-26.930000000000007,-32.129999999999995,-16.819999999999993,0,0,31059
2020-11-17,36,775,38,737,94,9,85,-12.5,14,-54,-46.5,-38,-25.659999999999997,-34.010000000000005,-11.189999999999998,0,0,31090
2020-11-18,32,707,42,665,79,7,72,-15,15,-57.5,-49,-37.5,-26.08,-25.17,-8.120000000000005,0,0,31378
2020-11-19,42,541,29,512,90,11,79,-11,15,-54.5,-45.5,-38.5,-26.03,-30.730000000000004,-10.200000000000003,0,0,31634
2020-11-20,40,466,28,438,78,8,70,-8,16,-57.5,-49.5,-38.5,-16.980000000000004,-32.56,-2.969999999999999,0,0,31785
2020-11-21,34,404,15,389,59,13,46,-12,12,-63,-57.5,-27,-27.400000000000006,-44.63,-11.61,0,0,31959
2020-11-22,42,381,33,348,63,9,54,-13.5,9,-62,-51.5,-25.5,-36.91,-42.75,-28.629999999999995,0,0,31952
2020-11-23,36,579,40,539,81,4,77,-14,14,-51,-45.5,-38,-26.480000000000004,-28.849999999999994,-17.11,0,0,31224
2020-11-24,36,465,22,443,61,6,55,-12,14,-53,-46,-37.5,-24.25,-26.430000000000007,-9.599999999999994,0,0,30773
2020-11-25,37,531,30,501,57,5,52,-14,15,-56.5,-49,-36,-24.370000000000005,-35.53,-11.150000000000006,0,0,30789
2020-11-26,47,505,52,453,63,6,57,-9,14,-52.5,-45.5,-36.5,-23.659999999999997,-33.94,-15.379999999999995,0,0,30905
2020-11-27,58,400,39,361,54,7,47,-4.5,15,-53,-47,-36.5,-15.319999999999993,-36.86,-1.1500000000000057,0,0,30549
2020-11-28,25,273,10,263,63,10,53,-12,12,-61.5,-58.5,-25,-25.230000000000004,-43.7,-9.129999999999995,0,0,30068
2020-11-29,27,307,16,291,53,10,43,-14.5,9.5,-61.5,-54.5,-23.5,-38.08,-43.08,-34.379999999999995,0,0,29768
2020-11-30,22,611,52,559,70,12,58,-10.5,13.5,-47.5,-45.5,-36.5,-23.989999999999995,-32.3,-18.450000000000003,0,0,29227
2020-12-01,38,547,39,508,47,4,43,-8,13,-48,-44,-34.5,-20.010000000000005,-32.68000000000001,-15.840000000000003,0,0,29066
2020-12-02,28,472,57,415,59,4,55,-8,12,-39,-42.5,-31,-20.010000000000005,-29.28,-5.939999999999998,0,0,29289
2020-12-03,38,364,15,349,56,7,49,-9,13,-39.5,-42.5,-32.5,-15.170000000000002,-23.86,-8.049999999999997,0,0,29155
2020-12-04,26,307,17,290,61,10,51,-7.5,14,-45,-45,-33,-5.659999999999997,-25.879999999999995,-1.3199999999999932,0,0,29286
2020-12-05,34,295,16,279,51,14,37,-4,8.5,-42.5,-43,-14.5,-11.290000000000006,-38.24,5.489999999999995,0,0,29340
2020-12-06,26,329,12,317,67,19,48,-8.5,7,-47.5,-44.5,-13.5,-27.900000000000006,-40.95,-32.55,0,0,29313
2020-12-07,24,548,42,506,79,7,72,-7.5,11,-32.5,-40.5,-33,-20.290000000000006,-30.680000000000007,-20.72,0,0,29014
2020-12-08,25,538,47,491,54,10,44,-7.5,12,-38,-41,-31,-16.950000000000003,-33.769999999999996,-22.200000000000003,0.010248901903367497,0,28275
2020-12-09,37,561,36,525,68,11,57,-8,12,-41,-42.5,-31,-18.08,-36.88,-17,0.05356989062096287,0,28024
2020-12-10,30,563,34,529,60,6,54,-5,12,-38.5,-41,-32,-17.989999999999995,-40.45,-25.78,0.09921626044268367,0,28559
2020-12-11,45,504,35,469,64,6,58,-2.5,12.5,-42.5,-42,-32,-8.670000000000002,-37.19,-16.709999999999994,0.1452071311687193,0,29028
2020-12-12,27,391,15,376,47,15,32,-7.5,8.5,-49,-47.5,-13,-20.58,-51.57,-26.209999999999994,0.18353285677374903,0,29373
2020-12-13,29,382,22,360,46,10,36,-15,8,-54.5,-52,-16,-37.28,-56.99,-51.41,0.22228920850917233,0,29434
2020-12-14,38,906,46,860,94,17,77,-6,11,-34.5,-40,-33.5,-22.629999999999995,-42.09,-31.159999999999997,0.2656101972267677,0,29507
2020-12-15,28,692,39,653,61,5,56,-3,11,-36.5,-39,-32.5,-21.870000000000005,-40.61,-27.319999999999993,0.3149599517698734,0,30015
2020-12-16,34,680,34,646,50,8,42,-7,12.5,-43.5,-44.5,-31.5,-22.689999999999998,-46.03,-31.200000000000003,0.35862544139178365,0,30292
2020-12-17,43,730,48,682,67,15,52,0.5,11.5,-37,-39.5,-33,-20.209999999999994,-47.17,-31.430000000000007,0.40668331754370857,0,31097
2020-12-18,36,691,32,659,50,6,44,-1.5,14,-43.5,-43,-36,-12.430000000000007,-43.13,-26.75,0.45319093962621654,0,31910
2020-12-19,37,458,26,432,73,15,58,-2.5,7.5,-47.5,-42.5,-12.5,-20.989999999999995,-55.13,-28.590000000000003,0.4997846869348032,0,32616
2020-12-20,30,545,20,525,53,10,43,-5.5,7,-49.5,-41,-9,-39.43,-56.61,-55.06,0.5514598225820342,0,33745
2020-12-21,33,935,27,908,82,13,69,10,14,-30,-47.5,-45.5,-26.08,-55.51,-38.52,0.6077857204375161,0,34294
2020-12-22,47,765,34,731,45,8,37,19,13.5,-29.5,-43.5,-46,-23.489999999999995,-50.71,-35.56999999999999,0.6980449573680131,0,34510
2020-12-23,50,760,33,727,64,6,58,18.5,16,-36.5,-50.5,-49,-22.510000000000005,-63.5,-39.87,0.7889931961071397,0,35223
2020-12-24,31,493,15,478,61,11,50,16,17.5,-39.5,-52.5,-61,-39.04,-76.31,-52.95,0.8376539488416157,0,33342
2020-12-25,24,240,12,228,27,7,20,-89,24.5,-94.5,-82,-83,-74.05,-80.66,-83.34,0.8376539488416157,0,29869
2020-12-26,15,832,29,803,73,16,57,-61.5,12.5,-79,-72.5,-47,-60.47,-69.56,-69.84,0.8379123245198519,0,29055
2020-12-27,39,850,28,822,80,21,59,-21,8,-55,-51.5,-22.5,-49.51,-65.07,-58.7,0.870898286108001,0,28355
2020-12-28,53,1117,32,1085,102,22,80,-24.5,23,-45,-66,-73,-44.19,-62.64,-55.73,0.930583067780553,0,25047
2020-12-29,48,1590,51,1539,57,11,46,-13.5,21,-44,-59.5,-63,-40.17,-57.03,-45.32,0.9932822323658599,0.0013780036172594953,25379
2020-12-30,68,1465,67,1398,72,9,63,-2,20,-39.5,-57,-60.5,-33.760000000000005,-62.33,-42.1,1.0720006890018086,0.003961760399621049,26360
2020-12-31,48,1215,37,1178,60,9,51,2,22.5,-60,-63.5,-66,-38.12,-68.27,-40.6,1.1443458789079322,0.005942640599431573,28121
2021-01-01,54,568,22,546,90,18,72,-68,30,-88,-83.5,-81.5,-60.95,-72.65,-67.28999999999999,1.1453793816208768,0.005942640599431573,29497
2021-01-02,49,1438,61,1377,82,16,66,-27,15,-73.5,-64,-35,-48.38,-64.21000000000001,-54.13,1.1776763414003961,0.006459391955903884,31805
2021-01-03,51,1240,43,1197,95,16,79,-25.5,11,-72.5,-61.5,-25.5,-51.85,-61.41,-60.57,1.234949616742744,0.008698647833950565,32715
2021-01-04,55,1944,107,1837,99,12,87,-19.5,17,-58.5,-57,-42.5,-40.96,-57.01,-43.31,1.3300318663336492,0.021617431745758333,35317
2021-01-05,33,1316,60,1256,89,12,77,-23.5,18,-64,-58,-44.5,-41.57,-59.39,-44.83,1.45026268193954,0.03203858410128326,35321
2021-01-06,55,1333,58,1275,78,10,68,-25.5,18.5,-66,-57.5,-44.5,-41.41,-57.63,-44.07,1.637240547756438,0.04633537163035053,35993
2021-01-07,61,1349,71,1278,82,7,75,-23,18.5,-64.5,-57.5,-45.5,-41.67,-55.18,-47.06,1.952889501334941,0.06571354749806217,37877
2021-01-08,69,1229,84,1145,83,10,73,-22.5,19.5,-67.5,-59.5,-45,-33.459999999999994,-56.18,-36.86,2.2497631556282838,0.08939798466970976,40999
2021-01-09,71,903,50,853,98,28,70,-23.5,13.5,-71,-61.5,-29,-40.77,-60.48,-32.92,2.5620532253897164,0.09172336577383516,40606
2021-01-10,66,880,39,841,93,14,79,-27,11.5,-72.5,-61,-27,-53.53,-64.21000000000001,-55.98,2.837567823615537,0.09275686848677978,40245
2021-01-11,62,1538,80,1458,98,7,91,-27.5,18,-62.5,-56.5,-45.5,-38.98,-52.66,-40.33,3.160451296184653,0.09404874687796055,39941
2021-01-12,68,1386,75,1311,103,15,88,-25,18,-63,-56.5,-45.5,-38,-50.76,-38.39,3.4788562569976746,0.09577125139953492,39746
2021-01-13,79,1213,52,1161,79,5,74,-30,18.5,-68,-60,-45.5,-39.03,-49.62,-43.7,3.8423908362759454,0.09628800275600723,39064
2021-01-14,65,1190,60,1130,88,12,76,-33.5,19.5,-71.5,-61,-49,-40.07,-56.56,-45.6,4.212901558866592,0.09689087933855826,38610
2021-01-15,69,1061,56,1005,72,6,66,-23,19.5,-68.5,-60,-48,-31.620000000000005,-55.47,-37.08,4.597192317629833,0.0974937559211093,37940
2021-01-16,60,766,27,739,85,16,69,-25.5,14,-72.5,-65,-32.5,-40.48,-59.79,-37.55,4.900439238653002,0.09861338386013263,37546
2021-01-17,65,836,39,797,75,12,63,-27,10.5,-71.5,-60,-26,-51.1,-56.42,-49.7,5.228317974334683,0.09921626044268367,37090
2021-01-18,107,1424,80,1344,104,9,95,-27,17,-62.5,-55.5,-47,-36.81,-48.65,-37.06,5.622513134096977,0.09947463612091981,35562
2021-01-19,67,1498,47,1451,67,5,61,-27.5,17.5,-64.5,-57.5,-47.5,-37.51,-52.02,-38.36,5.979243820515029,0.09981913702523468,35663
2021-01-20,95,1253,54,1199,92,10,82,-29,19,-68.5,-60.5,-47.5,-36.68,-52.99,-42.88,6.366721212643184,0.10042201360778572,36112
2021-01-21,80,1107,37,1070,101,13,88,-23.5,18,-64,-57,-47,-35.06999999999999,-53.11,-36.95,6.828352424425114,0.1008526397381793,36641
2021-01-22,73,956,34,922,103,13,90,-18.5,19,-65.5,-56.5,-46.5,-27.819999999999993,-54.35,-26.650000000000006,7.685901300490913,0.10111101541641547,37131
2021-01-23,72,751,28,723,88,14,74,-26,14,-72.5,-64.5,-32,-38.81,-61.19,-35.730000000000004,8.138747739212814,0.10145551632073034,36904
2021-01-24,57,534,20,514,99,19,80,-29,11,-74,-61,-32.5,-53.57,-58.08,-47.76,8.48385152011024,0.10162776677288778,36436
2021-01-25,53,1065,79,986,89,8,81,-30,19,-64.5,-56,-51,-41.91,-56.18,-39.48,8.86495564550857,0.10171389199896651,35542
2021-01-26,53,959,38,921,90,12,78,-26,18,-64.5,-58,-48,-35.980000000000004,-50.97,-39.99,9.295926276806476,0.10171389199896651,34596
2021-01-27,60,1005,59,946,81,8,73,-21.5,17.5,-64,-56.5,-46,-33.47,-53.07,-36.2,9.685815175264835,0.1021445181293601,34274
2021-01-28,57,864,33,831,79,6,73,-21.5,18,-63,-57.5,-47,-32.93000000000001,-51.64,-33.349999999999994,10.29558177590216,0.10291964516406855,33799
2021-01-29,50,859,47,812,71,10,61,-15.5,18,-63.5,-55.5,-46,-23.83,-50.17,-24.86,10.994401860304883,0.10369477219877703,33514
2021-01-30,57,714,32,682,74,11,63,-22,13.5,-69,-64.5,-31,-33.769999999999996,-61.31,-32.8,11.852467487727155,0.10429764878132806,33565
2021-01-31,56,606,17,589,66,14,52,-23.5,10,-68.5,-59.5,-27.5,-46.94,-57.63,-48.76,12.537421410731204,0.10481440013780036,33543
2021-02-01,32,1057,55,1002,60,5,55,-22,16.5,-58,-53.5,-46.5,-32.28,-47.17,-30.72,13.191887003703384,0.10627852898113857,32747
2021-02-02,45,809,32,777,68,5,63,-25.5,18,-64,-58.5,-47,-33.760000000000005,-53.4,-36.77,13.893290844888467,0.10843165963310654,32547
2021-02-03,57,798,30,768,77,5,72,-21,17.5,-63,-57.5,-45.5,-32.66,-51.45,-29.810000000000002,14.547239686504177,0.10980966325036604,32369
2021-02-04,58,832,47,785,71,11,60,-20,17.5,-61.5,-56.5,-46.5,-30.540000000000006,-50.33,-33.17,15.25751442597537,0.11170441822409784,32453
2021-02-05,52,715,31,684,45,7,38,-13.5,18,-62.5,-57.5,-45.5,-23.439999999999998,-51.59,-21.549999999999997,16.011110154164154,0.11316854706743605,32144
2021-02-06,47,597,20,577,56,13,43,-21,13.5,-69.5,-64,-31,-32.349999999999994,-57.41,-33.03,16.987684092670744,0.1134269227456722,32146
2021-02-07,55,606,22,584,64,12,52,-25,11,-70.5,-65,-29.5,-47.46,-58.89,-49.63,17.599345448281802,0.1143743002325381,32083
2021-02-08,56,894,53,841,72,7,65,-28,18.5,-64.5,-60.5,-49.5,-37.46,-49.67,-39.43,18.04297648781328,0.11558005339764017,31339
2021-02-09,44,608,31,577,66,9,57,-21,18,-61,-58,-47,-35.17,-50.52,-38.52,18.582723279648608,0.11738868314529326,31168
2021-02-10,74,673,25,648,62,11,51,-18.5,17.5,-61.5,-58.5,-45,-32.8,-49.83,-30.650000000000006,19.23314098699509,0.12048919128412712,31084
2021-02-11,45,621,18,603,45,9,36,-14,18,-59.5,-56,-46,-29.75,-49.69,-31.290000000000006,19.928429937128588,0.12272844716217379,30991
2021-02-12,37,659,19,640,51,7,44,-10.5,18,-61,-58,-46,-21.439999999999998,-49.9,-22.989999999999995,20.603737834811817,0.12496770304022049,31502
2021-02-13,33,353,13,340,60,20,40,-10.5,12.5,-66,-63,-29.5,-26.299999999999997,-54.71,-26.5,21.48393764533632,0.1283265868572905,31380
2021-02-14,30,346,10,336,55,15,40,-20,11,-68,-62.5,-28.5,-39.87,-54.52,-43.11,22.151494272672466,0.13151322022220308,31089
2021-02-15,27,862,48,814,68,3,65,-17.5,17,-55,-54.5,-50,-29.97,-45.15,-26.439999999999998,22.72310739815692,0.13513047971750927,30966
2021-02-16,45,553,21,532,61,12,49,-14,17,-56,-55,-49,-30.560000000000002,-46.53,-30.28,23.353285677374902,0.1436568770993024,30581
2021-02-17,23,517,17,500,57,7,50,-17,17.5,-57.5,-56,-49,-27.299999999999997,-45.87,-21.370000000000005,24.042718112135045,0.17095857376625614,30665
2021-02-18,52,552,20,532,67,8,59,-14,18,-57,-55.5,-49.5,-28.400000000000006,-46.34,-28.930000000000007,24.79855309620188,0.19757126862458013,30324
2021-02-19,40,468,10,458,65,13,52,-10.5,18.5,-60,-57,-49,-20.019999999999996,-41.18,-23.290000000000006,25.457841701834464,0.22418396348290415,30087
2021-02-20,36,308,9,299,55,9,46,-13.5,12,-64,-60,-28,-29.879999999999995,-46.72,-23.42,26.317371458100077,0.25493066919300666,30056
2021-02-21,21,370,12,358,52,10,42,-18.5,9.5,-65,-56,-25.5,-41.74,-47.53,-41.09,27.010335027129447,0.28688312806821115,30170
2021-02-22,36,670,19,651,58,5,53,-18,16,-54.5,-55,-45.5,-29.099999999999994,-36.29,-29.11,27.579192145379384,0.3213332184996986,29681
2021-02-23,23,555,26,529,49,11,38,-15.5,16,-56.5,-53.5,-44.5,-27.370000000000005,-39.54,-28.629999999999995,28.225475841874086,0.36189819998277495,29228
2021-02-24,29,368,15,353,38,1,37,-15.5,17,-58,-53.5,-43.5,-24.799999999999997,-35.69,-22.930000000000007,28.91654465592972,0.40065455171819825,29133
2021-02-25,28,335,16,319,42,5,37,-10,16,-55,-50.5,-44.5,-21.950000000000003,-37.4,-20.810000000000002,29.678925157178536,0.4421669106881405,29070
2021-02-26,30,269,9,260,38,3,35,-4.5,16,-56,-52.5,-43.5,-11.299999999999997,-35.34,-8.920000000000002,30.52820601154078,0.4883300318663336,28875
2021-02-27,30,297,13,284,56,14,42,-8,10.5,-60.5,-54,-25.5,-20.42,-39.62,-6.609999999999999,31.559383343381274,0.5325983980707949,28748
2021-02-28,21,167,4,163,56,8,48,-11,8,-58.5,-50.5,-22,-33.3,-45.41,-26.510000000000005,32.33339075015072,0.5785031435707519,28291
2021-03-01,13,316,11,305,74,11,63,-15,16,-53,-54,-44,-26.349999999999994,-30.42,-22.209999999999994,32.9599517698734,0.6198432520885367,27143
2021-03-02,22,286,7,279,41,3,38,-12.5,16,-55,-52,-44,-26.709999999999994,-35.790000000000006,-26.939999999999998,33.342778399793296,0.6697958832141935,26822
2021-03-03,10,235,14,221,38,6,32,-13.5,17,-58,-53.5,-43.5,-23.939999999999998,-38.05,-22.980000000000004,33.718198260270434,0.7273275342347774,26923
2021-03-04,14,255,5,250,50,8,42,-11.5,16.5,-56.5,-52,-43.5,-24.64,-40.71,-24.75,34.20446128671088,0.7771079149082766,26714
2021-03-05,22,207,8,199,44,5,39,-4.5,17,-57.5,-52.5,-42.5,-16.989999999999995,-38.66,-15.239999999999995,34.6867625527517,0.8101800017225045,26335
2021-03-06,12,147,6,141,64,14,50,-9,11.5,-61,-57.5,-25,-23.129999999999995,-47.53,-16.200000000000003,35.307553182327105,0.8338644388941521,26205
2021-03-07,5,151,2,149,42,9,33,-9,8,-60,-52,-21,-35.14,-43.82,-29.150000000000006,35.50460769959521,0.8570321247093273,26065
2021-03-08,10,258,8,250,43,4,39,-10,14,-51,-50,-41,-27.060000000000002,-33.86,-28.180000000000007,35.64852295237275,0.9045732495047799,25519
2021-03-09,9,285,7,278,33,3,30,-7.5,14,-52,-46.5,-40,-25.290000000000006,-37.98,-23.799999999999997,35.84178795969339,0.9647747825338041,25447
2021-03-10,7,245,6,239,36,6,30,-13.5,16,-59,-52,-40,-25.64,-34.93000000000001,-28,36.0602876582551,1.0386702265093446,25414
2021-03-11,15,182,5,177,31,6,25,-7,15,-55,-49,-40,-22.310000000000002,-38.24,-26.540000000000006,36.20626991645853,1.0861252260787184,25192
2021-03-12,18,203,9,194,21,4,17,1.5,15,-56,-48,-38,-22.310000000000002,-38.24,-26.540000000000006,36.60098182757729,1.1456377572991128,25593
2021-03-13,11,170,3,167,47,9,38,3.5,11,-61,-56.5,-23.5,-21.939999999999998,-45.48,-16.33,37.303763672379645,1.2086814227887348,25926
2021-03-14,5,150,5,145,44,9,35,-7.5,8,-62.5,-51.5,-13.5,-36.77,-46.39,-40.82,37.845491344414775,1.2593230557230213,25982
2021-03-15,10,232,4,228,61,9,52,-11,13.5,-50,-45.5,-39.5,-23.930000000000007,-35.43000000000001,-26.010000000000005,38.473430367754716,1.311773318404961,25936
2021-03-16,12,268,6,262,32,1,31,-7,13.5,-51.5,-45.5,-39.5,-23.349999999999994,-34.36,-21.75,39.24941865472397,1.3795538713289122,26624
2021-03-17,14,275,7,268,39,5,34,-7,13.5,-53.5,-46,-38,-19.090000000000003,-31.870000000000005,-13.200000000000003,40.01300490913789,1.4368271466712599,27433
2021-03-18,12,222,4,218,47,6,41,-5.5,14,-54,-46,-39,-21.33,-36.72,-23.680000000000007,40.75213159934545,1.534407027818448,27955
2021-03-19,14,202,5,197,43,6,37,-2,15,-57,-48,-38,-12.700000000000003,-33.459999999999994,-9.709999999999994,41.55309620187753,1.6363792954956509,28637
2021-03-20,12,167,8,159,49,10,39,-7.5,10.5,-60.5,-53,-22.5,-18.61,-38.09,-10.829999999999998,42.80096460253208,1.782189303246921,29014
2021-03-21,9,215,0,215,40,10,30,-10.5,8.5,-60.5,-48,-19.5,-31.89,-42.02,-30.810000000000002,43.733011799155975,1.860132632848161,29163
2021-03-22,6,197,2,195,53,13,40,-7.5,13,-48,-43.5,-38.5,-22.709999999999994,-27.569999999999993,-19.909999999999997,44.26836620446129,2.0418568598742572,29136
2021-03-23,9,228,2,226,46,10,36,-7.5,13,-50.5,-45,-38.5,-20.239999999999995,-30.730000000000004,-20.879999999999995,44.562311601067954,2.3287399879424684,29171
2021-03-24,7,216,4,212,71,8,63,-6.5,13,-53,-46.5,-37,-18.03,-32.41,-16.33,44.893204719662386,2.6887434329515116,29192
2021-03-25,9,201,4,197,51,7,44,-3,13,-50.5,-44.5,-37.5,-16.069999999999993,-27.120000000000005,-12.150000000000006,45.226939970717424,3.0846610972353803,29058
2021-03-26,8,181,3,178,35,5,30,0.5,14.5,-54.5,-48,-37.5,-6.469999999999999,-30.200000000000003,-11.780000000000001,45.636120919817415,3.3882525191628625,28794
2021-03-27,10,128,2,126,43,9,34,-4.5,10,-59,-52.5,-21.5,-14.719999999999999,-41.16,-10.64,46.28705537852037,3.6259581431401253,28532
2021-03-28,3,158,4,154,50,7,43,-13.5,9,-64,-55,-19.5,-30.230000000000004,-42.28,-38.56,46.60089570235122,3.8797691843941093,28404
2021-03-29,4,105,4,101,49,10,39,-4,11.5,-44.5,-41.5,-37,-11.340000000000003,-24.760000000000005,-12.209999999999994,46.78546206183791,4.134527603134958,27628
2021-03-30,11,95,7,88,43,6,37,1.5,11,-46.5,-40,-37,-6.219999999999999,-19.459999999999994,-1.6299999999999955,46.97915769528895,4.4832486435276895,26817
2021-03-31,6,120,3,117,33,9,24,3,11.5,-48.5,-41,-36.5,-1.5900000000000034,-24.519999999999996,-6.859999999999999,47.179226595469814,4.800447851175609,26404
2021-04-01,11,137,1,136,49,7,42,13,12,-44,-40.5,-37.5,-9.260000000000005,-29.78,-19.700000000000003,47.320988717595384,5.159676169149944,26278
2021-04-02,13,103,9,94,53,14,39,2.5,20,-53.5,-56.5,-65.5,-15.239999999999995,-34.55,-22.569999999999993,47.42261648436828,5.4239944879855315,25207
2021-04-03,8,84,2,82,60,16,44,1.5,8.5,-60,-51,-26,-17.099999999999994,-45.39,-24.700000000000003,47.635001291878396,5.678494531048144,24955
2021-04-04,8,76,1,75,50,8,42,-42.5,6,-75,-46.5,-21.5,-35.010000000000005,-48,-41.92,47.697442080785464,5.866678150030144,24523
2021-04-05,6,111,1,110,56,11,45,-16,22,-51.5,-63,-73,-26.39,-35.17,-40.4,47.74188269744208,6.07260356558436,22002
2021-04-06,13,112,3,109,42,8,34,-4.5,15,-48.5,-48,-47,-15.010000000000005,-28.47,-27.310000000000002,47.89906123503574,6.321419343725777,22172
2021-04-07,7,102,3,99,28,7,21,-8.5,15,-51.5,-48,-44.5,-12.349999999999994,-35.239999999999995,-23.980000000000004,48.067349926793554,6.630264404444061,22496
2021-04-08,12,106,5,101,28,6,22,-5.5,14.5,-50.5,-46,-44.5,-13.920000000000002,-38.64,-25.040000000000006,48.145723882525196,7.056498148307639,22377
2021-04-09,6,69,4,65,36,6,30,-4,15,-55,-48,-43.5,-10.61,-35.53,-24.879999999999995,48.29170614072862,7.636465420721729,23739
2021-04-10,4,67,1,66,32,5,27,-8,9,-61,-50,-19,-16.159999999999997,-42.23,-27.150000000000006,48.453277064852294,8.066747050211006,23714
2021-04-11,9,68,1,67,32,10,22,-11,7.5,-60,-46.5,-15.5,-20.700000000000003,-37.62,-36.81,48.48841615709241,8.402204805787616,23803
2021-04-12,8,76,0,76,27,8,19,-4.5,9.5,-20.5,-34.5,-41.5,-5.010000000000005,-23.909999999999997,1.9099999999999966,48.51520110240289,8.759710619240375,24485
2021-04-13,14,78,2,76,23,3,20,-1.5,11,-27,-37,-41.5,-5.099999999999994,-22.689999999999998,1.3700000000000045,48.58952717250883,9.345965033158212,24431
2021-04-14,3,79,2,77,29,7,22,-2.5,11,-30.5,-38,-41.5,-5.150000000000006,-20.269999999999996,-1.1599999999999966,48.656877099302385,9.83463956592886,24409
2021-04-15,9,53,2,51,17,2,15,1,11,-28,-35.5,-42,-2.769999999999996,-15.900000000000006,1.3100000000000023,48.90130049091379,10.334165877185427,24173
2021-04-16,7,69,0,69,15,1,14,1,10.5,-34.5,-36,-41,3.430000000000007,-16.799999999999997,10.150000000000006,49.08474722246146,10.887951080871588,23971
2021-04-17,4,22,1,21,33,5,28,-2,4.5,-40.5,-33.5,-16,-2.9200000000000017,-26.64,20.879999999999995,49.350099044009994,11.606666092498493,24150
2021-04-18,11,67,1,66,39,14,25,-1,3.5,-40,-30,-12.5,-11.849999999999994,-19.989999999999995,-10.879999999999995,49.44345878907932,12.286021875807423,24525
2021-04-19,6,72,1,71,38,9,29,0.5,8.5,-27,-30.5,-33,-5.230000000000004,-4.469999999999999,13.590000000000003,49.52605288088881,12.838429075876324,24708
2021-04-20,6,82,1,81,33,4,29,2,9,-30,-30.5,-31.5,-4.5,-3.3499999999999943,10.090000000000003,49.60442683662045,13.490999913874774,24787
2021-04-21,4,84,1,83,25,5,20,-2.5,10,-35,-35,-31.5,-2.8599999999999994,-0.7800000000000011,10.280000000000001,49.67237963999656,14.200930152441652,25184
2021-04-22,0,59,0,59,18,3,15,3.5,8.5,-28.5,-31,-30.5,-1.9399999999999977,-7.8700000000000045,16.39,49.7944190853501,14.914736026182068,25592
2021-04-23,4,58,1,57,28,7,21,7,8,-32,-31,-29.5,6.989999999999995,-6.489999999999995,34.25,49.90112824046163,15.668934630953407,26111
2021-04-24,1,52,3,49,36,11,25,1,4,-36.5,-35,-13.5,2.2099999999999937,-12.86,43.28999999999999,50.0198088019981,16.505468951856,26331
2021-04-25,3,42,2,40,22,5,17,-1.5,3.5,-38,-36,-12,-10.480000000000004,-21.08,-7.090000000000003,50.06106278528981,17.125742830074927,26015
2021-04-26,2,55,3,52,33,5,28,-1.5,8.5,-26.5,-32.5,-31,-5.409999999999997,-6.769999999999996,4.040000000000006,50.10102489019034,17.72999741624322,25544
2021-04-27,4,62,2,60,21,2,19,-1.5,10,-35,-36,-31,-4.319999999999993,-4.040000000000006,-1.230000000000004,50.19843252088537,18.294462147963138,25160
2021-04-28,11,60,3,57,24,4,20,-1.5,10,-35.5,-37.5,-30.5,-2.0799999999999983,0.35999999999999943,9.430000000000007,50.29962966152786,18.932391697528207,25553
2021-04-29,2,57,1,56,21,4,17,1.5,9.5,-31.5,-33,-31,0.4899999999999949,-1.7099999999999937,13,50.37808974248558,19.64111618292998,25297
2021-04-30,3,33,1,32,23,8,15,7.5,8.5,-31.5,-31.5,-29.5,14.670000000000002,3.299999999999997,31.590000000000003,50.4326070105934,20.320730341917148,25270
2021-05-01,3,35,2,33,34,7,27,0.5,5,-36,-37,-15.5,5.6200000000000045,-10.030000000000001,43.96000000000001,50.61407286194126,21.066316424080615,25129
2021-05-02,2,24,1,23,34,7,27,-2.5,3.5,-34.5,-35,-13,-11.689999999999998,-21.200000000000003,6.980000000000004,50.73146154508655,21.78494531048144,25045
2021-05-03,3,58,3,55,44,9,35,-18,20.5,-38.5,-59.5,-72.5,-11.480000000000004,-16.299999999999997,-17.930000000000007,50.83463956592886,22.333735251055035,22973
2021-05-04,6,83,1,82,40,9,31,0.5,10.5,-35.5,-36.5,-31.5,-1.4899999999999949,-7.319999999999993,-0.04999999999999716,50.95090862113513,22.873654293342522,23439
2021-05-05,3,77,0,77,26,5,21,-1,9.5,-35,-36.5,-29.5,0.46999999999999886,-1.4500000000000028,13.11,51.06468004478511,23.463353716303505,24001
2021-05-06,5,82,1,81,38,9,29,3,9.5,-31,-32,-30,0.23999999999999488,-6.730000000000004,14.189999999999998,51.21100680389286,24.202308156058912,24322
2021-05-07,5,64,3,61,30,10,20,4.5,8.5,-33,-32.5,-28,7.290000000000006,-9.150000000000006,30.74000000000001,51.367840840582204,24.91206614417363,24940
2021-05-08,3,39,0,39,46,13,33,-7,9,-49,-51.5,-19,-2.6899999999999977,-19.560000000000002,8.799999999999997,51.58987167341314,25.820945654982346,25082
2021-05-09,1,77,1,76,44,10,34,-3,4.5,-37.5,-39,-9.5,-9.709999999999994,-8.290000000000006,-4.5,51.74084919472913,26.583412281457242,25275
2021-05-10,1,95,1,94,34,4,30,-3,9.5,-30.5,-34,-30.5,-3.519999999999996,-5.010000000000005,-4.689999999999998,51.813452760313496,27.309361812074755,26179
2021-05-11,2,51,1,50,44,6,38,0,9.5,-32,-35,-29.5,-2.8100000000000023,-9.769999999999996,-1.25,51.91335802256481,27.971406424941865,26431
2021-05-12,0,71,0,71,29,4,25,2.5,9,-32,-35,-29,-2.430000000000007,0.519999999999996,15.89,52.01946430109379,28.670140384118508,26824
2021-05-13,1,73,2,71,29,5,24,4.5,9,-28.5,-34.5,-31,-2.680000000000007,-1.9699999999999989,6.950000000000003,52.163896305227794,29.414692963569028,27056
2021-05-14,3,64,1,63,33,3,30,7,8.5,-33.5,-34,-28.5,6.680000000000007,-6.8700000000000045,23.36,52.25760055120144,30.207561794849713,27266
2021-05-15,0,50,2,48,39,6,33,1.5,6,-38.5,-42,-15,2.549999999999997,-15.379999999999995,21.689999999999998,52.378003617259495,31.222375333735254,27608
2021-05-16,5,65,0,65,35,7,28,0,4.5,-38,-38.5,-10,-8.629999999999995,-13.620000000000005,-14.86,52.52708638360176,32.00499526311257,27716
2021-05-17,0,63,0,63,46,7,39,-1,7.5,-21,-31,-28,-0.4399999999999977,0.4300000000000068,12.480000000000004,52.607527344759276,32.64817845146843,27705
2021-05-18,1,45,1,44,35,7,28,1,8.5,-24,-31.5,-28,2.819999999999993,-0.18999999999999773,12.590000000000003,52.78038067349927,33.252863663767116,27762
2021-05-19,5,62,0,62,33,9,24,1,8,-25,-31,-26.5,2.0900000000000034,3.6099999999999994,21.549999999999997,53.05201963655155,33.693308069933686,28082
2021-05-20,2,74,0,74,32,6,26,-0.5,9.5,-27.5,-34,-28.5,2.480000000000004,0.7399999999999949,11.86,53.31590732925674,34.21824132288347,28438
2021-05-21,2,55,0,55,39,5,34,4,8.5,-30,-31.5,-27.5,19.22,2.950000000000003,44.21000000000001,53.57540263543192,34.6843510464215,28729
2021-05-22,7,39,1,38,48,13,35,0.5,3,-27.5,-28.5,-10.5,13.540000000000006,1.2099999999999937,87.69,53.91025751442597,35.529239514253725,28820
2021-05-23,4,39,1,38,51,8,43,-3,2.5,-32,-26,-7.5,-3.319999999999993,-5.890000000000001,2.1599999999999966,54.39290328137112,35.86099388510895,28743
2021-05-24,7,50,1,49,32,3,29,-2,8.5,-23.5,-31.5,-29,1.4200000000000017,0.14000000000000057,2.769999999999996,54.76332787873568,36.16131254844544,28700
2021-05-25,0,57,1,56,37,5,32,3.5,8.5,-24,-32.5,-27.5,4.359999999999999,1.1599999999999966,9.659999999999997,55.12350357419689,36.52734475928,29388
2021-05-26,2,52,1,51,34,6,28,1,8,-26.5,-33.5,-26.5,8.14,6.6299999999999955,18.099999999999994,55.462750839720954,36.84342433898889,30319
2021-05-27,5,41,1,40,30,3,27,6.5,7,-15.5,-28,-26.5,10.25,6.579999999999998,25.040000000000006,55.88209456549823,37.16579106020153,30864
2021-05-28,2,39,0,39,17,5,12,12.5,5.5,-15.5,-22.5,-27,31.180000000000007,17.180000000000007,64.75,56.20859529756266,37.56558435965894,31091
2021-05-29,2,49,0,49,41,9,32,3.5,0,-23.5,-22.5,-12,18.230000000000004,5.730000000000004,96.74000000000001,56.57075187322367,38.22685384549134,31037
2021-05-30,0,64,0,64,32,8,24,5.5,-1,-16,-20,-8.5,3.5999999999999943,-2.469999999999999,60.30000000000001,56.90543450176556,38.752303849797606,30512
2021-05-31,1,64,2,62,49,11,38,-6.5,12.5,-14.5,-44.5,-70.5,3.180000000000007,-0.1700000000000017,20.290000000000006,57.04013435535268,39.21789682197916,27817
2021-06-01,0,118,0,118,29,4,25,11.5,8,-11.5,-31,-40.5,15.86,18.870000000000005,39.75999999999999,57.140039617603996,39.76634226164843,27282
2021-06-02,1,153,0,153,34,8,26,6,8,-16.5,-33,-38.5,18.519999999999996,19.11,48.03,57.21402118680562,40.34941004220136,26929
2021-06-03,3,97,0,97,29,4,25,5,8.5,-13.5,-32,-39.5,15.370000000000005,13.969999999999999,41.889999999999986,57.34751528722762,40.970803548359314,26617
2021-06-04,3,74,1,73,30,8,22,7,7.5,-19,-29.5,-37.5,42.53999999999999,20.58,71.91,57.51778485918525,41.54741193695634,27006
2021-06-05,1,76,2,74,41,8,33,5,0.5,-25,-24,-6.5,17.019999999999996,13.049999999999997,90.19999999999999,57.68529842390836,42.65058995779864,27255
2021-06-06,0,115,0,115,52,16,36,1,1.5,-27,-28,-5,5.450000000000003,-2.0400000000000063,4.480000000000004,57.84738609938851,43.50452157436913,27762
2021-06-07,1,171,1,170,33,4,29,4.5,7.5,-16,-30.5,-27,10.370000000000005,15.090000000000003,18.010000000000005,57.979932822323654,44.04254586168289,28970
2021-06-08,0,189,0,189,49,6,43,10,7,-16,-30.5,-25,10.269999999999996,15.299999999999997,32.05000000000001,58.197485143398495,44.402290931013695,28879
2021-06-09,0,230,2,228,48,4,44,6.5,7,-19,-32,-25,11.700000000000003,24.790000000000006,35.18000000000001,58.51442597536819,44.75195934889329,28747
2021-06-10,3,179,4,175,39,9,30,8.5,7,-16,-30,-25.5,10.989999999999995,18.349999999999994,32.41999999999999,58.7219877702179,45.11669968133666,28774
2021-06-11,1,201,0,201,35,12,23,11,6,-20,-27.5,-24.5,22.5,19.840000000000003,57.59,59.03143570751873,45.449143054000515,28931
2021-06-12,2,168,1,167,53,5,48,6,1,-24.5,-27,-6,13.819999999999993,17.129999999999995,85.84,59.49866505899578,46.0323830850056,29033
2021-06-13,0,160,2,158,40,6,34,3.5,0,-31,-24.5,-4.5,3.1200000000000045,13.209999999999994,20.83,59.93583670657136,46.367065713547504,28804
2021-06-14,2,221,1,220,41,7,34,3.5,7.5,-18,-31.5,-27,6.109999999999999,21.58,23.299999999999997,60.30763930755319,46.55344070278184,28604
2021-06-15,2,324,2,322,41,3,38,8,7,-16.5,-30.5,-25,9.86,20.840000000000003,32.110000000000014,60.5625699767462,46.685298423908364,29383
2021-06-16,1,337,0,337,37,2,35,7,6.5,-19.5,-31,-25.5,12.549999999999997,33.50999999999999,40.18000000000001,60.86271638963052,46.84075445698045,30070
2021-06-17,2,303,2,301,48,4,44,6,8,-20,-32,-27,13.670000000000002,22.549999999999997,38.599999999999994,61.08112996296615,47.00189475497373,31178
2021-06-18,4,315,5,310,50,7,43,4,7,-28.5,-32,-26.5,25.17,25.64,49.44999999999999,61.419343725777274,47.13848936353458,32217
2021-06-19,3,235,1,234,52,8,44,4,2,-26,-31,-8,13.480000000000004,9.549999999999997,73.5,61.876065799672716,47.36465420721729,32589
2021-06-20,5,271,1,270,43,8,35,1.5,1.5,-25.5,-29,-4,-4.109999999999999,-4.209999999999994,0.4300000000000068,62.31056756523986,47.47213848936354,33012
2021-06-21,0,456,2,454,49,3,46,-2,8,-21,-32,-28,7.849999999999994,19.769999999999996,22.299999999999997,62.62104900525364,47.53483765394884,33021
2021-06-22,1,455,8,447,41,6,35,3.5,7,-18,-32,-26,9.840000000000003,13.64,33.06,62.87339591766429,47.67530789768323,33156
2021-06-23,5,502,5,497,42,2,40,2,7,-20,-32.5,-25.5,9.540000000000006,20.200000000000003,34.02000000000001,63.11833606063216,47.78365343209026,33970
2021-06-24,5,504,2,502,59,3,56,4.5,7.5,-17,-30.5,-28,13.420000000000002,15.849999999999994,35.21000000000001,63.367668590130044,47.85909913013522,34184
2021-06-25,5,603,3,600,45,5,40,6.5,6.5,-21,-28,-27,26.269999999999996,14.349999999999994,53.28,63.675566273361476,48.011713030746705,34513
2021-06-26,6,587,2,585,56,12,44,-0.5,1,-23.5,-25.5,-6.5,18.75,8.39,93.6,64.09973301179916,48.247093273619846,35299
2021-06-27,5,665,3,662,52,10,42,0,1.5,-25.5,-23,-6,4.230000000000004,-0.35999999999999943,3.730000000000004,64.47360261820687,48.389286021875805,35792
2021-06-28,6,987,11,976,56,3,53,-1.5,7.5,-20,-32.5,-29,4.030000000000001,5.489999999999995,0.8599999999999994,64.7575574885884,48.517612608733096,36632
2021-06-29,8,1011,4,1007,55,7,48,-2,7,-22.5,-36,-29,14.730000000000004,-0.14000000000000057,11.219999999999999,64.87770217896822,48.595900439238655,37540
2021-06-30,7,937,8,929,52,6,46,0.5,7,-22,-34.5,-26.5,5.8700000000000045,1.8799999999999955,12.569999999999993,65.05391439152528,48.699595211437426,38336
